6 10
|--------|
|F..|....|
|........|
|F...P@|.|
|......|.|
|--------|
